※
建築工事概要
位置	釜山府大倉町四丁目一六
廣袤	間口贰拾間奧行貳拾壹間半
建坪	壹百九拾四坪參合
延坪	五百八拾四坪七合
工費	拾七萬圓
起工	大正十五年八月
竣工	昭和參年參月
構造	煉瓦、鐵筋混凝土併造
階數	四階(壹部地階)
軒高	地上五十二尺五寸
階段	拾壹個所(幅自十六尺至三尺)
各階諸室の配置
地中階	倉庫二、
壹階	表玄關、左右玄關二、下足預場、食堂、配膳室、碁將棋室、球載室、小集會室、理髪室、化粧室二、便所二個所、倉庫、配管室二、電動ボンプ室一
貳階	大集會室、演壇、控室二、特別控室一、喫烟室二、化粧室二、便所二個所、小室一
建築工事概要(つづき)
參階	觀覽席(階段座席)喫烟室、控室二、化粧室、便所二個所、物置室
四階	觀覽席(階段座席)映寫室
給水設備	上水道を各所要の個所へ給水す
衛生裝置	敷地の一隅に淨化槽を設置し各所より流集したる汚水は細菌自然淨化法に依り處理し電働裝置に依り之を排除す
非常設備	隣接ホテルとの境界に自動防火扉を設け後部屋外に鐵製非常階段の設備あり
煖房設備	室内煖房用として「セクショナル」型蒸汽鍵貳基を設置し各室の放熱器に依り必要溫度を保持せしむる裝置と爲す
電氣設備	照明用として電燈貳百貳拾參燈此燭光壹萬貳千參拾壹燭光を算す、此の外に動力用電氣を裝置す
電氣扇	夏期用として各室に電氣扇取付の設備あり
電話電鈴	公設電話の外各室に呼鈴の設けあり
主要各室の一班
大集會室	第二階の廣間にして壹百拾坪演壇八坪及附屬室三室十六坪を有し第二階廣間は六百六拾八人第參階觀覽席は壹百五拾人第四觀覽席以壹百八拾五人合計壹千參人の座席を設け得若し通路を狭むるに於ては裕に壹千五百人を收容するに足る
小集會室	第壹階東北隅の室にして面積貳拾九坪餘にして收容人員四拾人乃至八拾人の集會に適す
映寫室	前面四階に在りて總て不燃燒物を以てし最新式映寫機械貳基を備ふ
俱樂部
球載室	球戯豪二臺を設備す
基將棋室	二十一疊敷純日本座敷にして碁將棋を備ふ
理髮室	理髪業者に貸付し經營せしむ
食堂	(配膳室を附設す)
建築工事關係者
設計監督	朝鮮總督府建築課長	岩井長三郎
現場監督	釜山府囑託	鈴木彌三郎
建築工事請負者	釜山	木下元次郎
煖房工事請負者	京城	芳賀豐吉
衛生工事請負者	株式會社須賀商會京城支店
電燈及電氣工事請負者	釜山瓦斯電氣株式會社
電燈器具設備工事請負者	釜山	加藤慶三郎
室内装置工事請負者	旭金庫株式會社釜山支店
＠