工事槪要
明治製菓京城賣店新築工事槪要
位置	京城本町二丁目九十二番地
建物坪數	延坪貳百貳拾坪八合一勺餘
内譯
地下室	貳拾四坪五五七
壹階	六拾四坪一八三
貳階	六拾參坪五二六
參階	六拾參坪五二六
屋階	五坪〇二四
構造槪要
基礎	割栗石及鑛筋コンクリート地形
主體	鐵骨及鐵筋コンクリート
軒高	屋階軒上端迄四十六尺五寸
總高	裝飾搭最上端迄五十五尺五寸
壁仕上
外部	白色セメント入人造石洗出塗り各蛇腹は人造石研
出し塗り。
內部	主要室は腰羽目胡桃材「ワニス」仕上げ、其他各
室に應じ人造石研出塗り、或は「タイル」張とな
し上部は喫茶室壁紙張り、其他漆喰塗り。
工期
起工	昭和五年四月十五日
竣工	昭和五年九月二十五日
設計者
東京	森山松之助事務所
工費及請負者
建築工事	五七、八六四圓餘	多田工務店
衞生煖房裝置	八、〇二六圓	杉山製作所
電氣設備	五、七六四圓	島田電氣商會出張所
