※
工事槪要
仁川府廳舍新築工事槪要
樣式	近代式
規模	二階建(中央背面三階建地下室付)
間口貳拾五間、奧行八間
建坪	百九拾八坪五合八勺
延坪	四百拾貳坪參合五勺
室數	拾五
軒高	參拾參尺九寸五分
階段室軒高	參拾九尺八寸
構造	壁體	煉瓦造、室內間仕切一部木骨鐵網張
屋根	陸屋根、外壁タイル貼床、鐵筋混凝土造
事務室	リノリユーム敷、廣間廊下等モザイツクタイル貼
窓	スチールサツシユ
諸設備
煖房	混合重力式蒸汽煖房、放熱器五六箇
衞生	水洗式、汚水淨化裝置
電氣	電燈五七箇、電氣時計壹參箇、サイレン壹筒、避雷針壹箇所
電話	構內電話(共電式)貳七箇所、直通電話五箇所
起工	昭和七年八月貳拾九日
竣工	昭和八年六月貳拾五日
(官舍移築及構內砂利敷の一部を除く)
工費	金六萬八千圓
工事關係者(府廳に直接實施の分を除く)
一廳舍正門、敷地々均シ竝ニ排水工事其他	長門組
一窓掛及敷物(絨氈)	高島屋
一電燈設備其他	山田鈴太郞
一煖房裝置・衞生裝置	芳賀豐吉
一電話交換裝置電氣時計設備	大倉商事
@