※
京城府立順化院新築工事槪要
位置	京城府玉仁洞四十六番地
敷地面積	七千九百三十坪
建築面積	八百十九坪
病舍建坪	百九十三坪七五
同	延坪	七百二十四坪五八
溫突病舍	六十五坪七七
渡廊下其他附屬家	二十三坪四四
軒高	地盤面よりパラペペツト上端迄四十四尺
名階室配置
地下室	煖房機關室、電氣室、通夜室、禮拜堂、屍體室、エレベーター室、便所、階段室、炊事場、廊下、出入口
一階	二等病室、三等病室、重病室、看護婦室、便所、洗面給湯室、物置、エレベーター室、階段室廊下
二階	特等病室、一等病室、二等病室重病室、談話室、小賄室、看護婦室、便所、洗面給湯室、物置エレベーター室、階段室
三階	一等病室、二等病室、三等病室重病室、其他二階同斷
屋上	階段室、エレベーター機械室、タンク室
溫突病室	病室、看護婦詰所、浴室、水碎室、便所、玄關、渡廊下
樣式	近世式
基礎	布掘割栗搗固めの上、鐵筋コンクリート造基礎版及び繫梁を築造す。
主體構造	柱.梁、床版鐵筋コンクリート構造、外壁煉瓦一枚積、內部間仕切木造とす。
外部仕上	腰、人造石洗出仕上、上部滿洲產リソイド塗、窓臺一部花崗石使用、パラペツト內側モルタル塗刷毛引陸屋根はコンクリートにて勾配取り防水屑の上に押ヘシンダーコンクリート打、アスフアルトモルタル塗、仕上セメントタイル敷きとす。
內部仕上	地階を除き室內は全部コンペス床地階モルタル仕上。廊下、階段人造石硏出、便所、洗面所、タイル張り、幅木は床と同材にて仕上、壁及天井コタツコマンチユリヤ、腰オイルペイント仕上。
建具造作	外側窓は上げ下げ式エヤータイトスチールサツシとし、內側に取外し式防蟲網戶を取付く、室內の窓出入口等紅松材オイルペイント仕上、尙各室にはブラインド、レヂスター等を取付け、ベツトの外に衣類戶棚、折疊み式ソフアー等を設備す。
煖房裝置	低壓眞空蒸汽煖房式とし、地下室に汽罐一臺を据付け、各室のラヂエーターに蒸氣を供給し、極寒零下22度の場合華氏60度の溫度を保持せしむ。
衛生設備	便所は水洗式とし、汚水淨化槽を設けポンプアツプして溜桝に導き、敷地各排水と共に鹽素滅菌裝置に依り完全滅菌して河川に放流す。但し患者の汚物は燒却釜により處理するものとす、又各階に芥投入口を設けダストシウトにより地階屋外に導き燒却す。廊下には消毒槽を設け隨時消毒することな得。
瓦斯設備	前金メタル附三箇所瞬間湯沸器三箇所を備へ、患者附添ひの便に供し尙地階炊事室に配管す。
消火栓設備	各階廊下に一箇所宛水道直結の消火栓を設備す。
昇降機	日本エレベーター株式會社製、マイクロドライブ式患者輸送用一臺を設置す。速度毎分百呎最大積載量678瓩。
電氣設備	地下室に高壓低壓、配電盤を備へエレベーター淨化槽、煖房及電燈(197燈)照明に使用す。
エ程	着工	昭和七年九月二十一日。
竣工	昭和八年八月十五日
工費	十四萬圓。
工事關係者	設計監督	京城府營繕係
工事請負	東亞工業株式會社
@