※
工事槪要
朝鮮總督府遞信局分館新築槪要
所在地	京城府光化門通一四九番地及一五〇番地
敷地	二七三七・一九平方米(約八二八坪)
建物大さ	高さ道路面より三階扶壁上端迄	一四・七米(約四八・五尺)
屋上最高部迄	一七・七米(約五八・四尺)
煙突頂部迄地階床より	三〇・〇米(約九九・〇尺)
階數	地上三階	地下一階	但し一部地階なし
廳舍延面積	三九七二・八四平方米(一二〇一・七四坪)
各階面積竝に用途
地階	六四五・五平方米(約一九五・二六四坪)煖房汽罐室、階段廣間、倉庫賣店、小使室、便所、洗面所、浴室、其他
一階	一〇八四・三七平方米(約三二八・○二二坪)
玄關、階段廣間、應接室、監視室、事務室、便所、洗面所、其の他
二階	一〇九〇・三〇平方米(約三二九・八一六坪)
階段廣間、應接室、事務室、便所、洗面所、其他
三階	一〇一七・七七平方米(約三○七・八七五坪)
階段廣間、應接室、事務室、會議室、便所、洗面所
屋階	一三四・九平方米(約四〇・八〇七坪)
階段廣間、昇降機械室、水槽室、物置
樣式	近代式
構造主體	骨組鐵筋「コンクリート」造壁體は
大部分煉瓦にて塡充す。
外部仕上	西側南側及北側一部は白色タイル張り東側及北側一部は白色「ネールクリート」塗、陸屋根は「モルタルブロフク」敷き塔屋は防水「モルタル」塗
內部仕上
天井	大部分漆喰塗課長室、二三階應接室、會議室は海綿仕上の上にペンキ塗
壁及腰廻り	玄關大理石、第一階段(一階踊場迄)廣間及廊下人造硏出	地階廣間煖房汽罐室、小使室其他腰廻りモルタル塗	便所、洗面所タイル張り、課長室二、三階應接室會議室チーク腰羽目其他槪ね漆喰塗
床	玄關大理石、廊下及階段人造硏出、一階第一應接室フローリングプロツク、會議室寄木張りの上に絨氈敷、便所、洗面所タイル張り課長室事務室一階第二應接室二、三階應接室モルタル塗りの上にリノリーム敷煖房汽罐室、小使室、倉庫其他モルタル塗
建具	外部窓及出人口は全部鐵製ペンキ塗內部出入口にはベニヤドア使用
昇降機	特許東松式「シングルラツプトラクシヨン」型乘客用電力昇降機一臺を設く
煖房設備	單管式低壓蒸氣煖房とし汽罐は福岡齋藤製作所製「アサヒボイラ」(自動給炭機付)三基を備へ最高五封度の蒸氣を發生せしめ是より各階の放熱器に導くものとす尙此の汽罐を利用し地階汽罐室內に備付ある「ストレヂータンク」に蒸氣を送り各階の洗面所竝に浴室等に給湯をなす。
給水設備	飮料洗面、汽罐用としては府設上水道を引用し、衞生、雜用としては井水を使用す。
消火設備	各階廣間及屋外に消火栓竝に火災報知機を設備す。
電氣設備	京城電氣株式會社より低壓三相三線式にて二一〇ヴオルト及單相二線式にて一〇五ヴオルトの供給を受け電動機總馬力數一九馬力電燈消費電力二九キロワツトに各々金屬管隱蔽工事を以て配電す。
照明電燈二一六燈、小型器具差込口一七箇扇風機四箇
電氣時計設備
日本電氣株式會社のW.E式とす。
親時計	一箇
子時計	四十一箇
電話交換設備
富士電機株式會社製シーメンハルスケ式とす。
コールフアインダー式一〇○囘線自
働電話交換機	一臺
局線中繼臺	一臺
電話機	六四箇
@
