※
昭和麒麟麥酒株式會社工場新築工事槪要
位置	京畿道始興郡永登浦邑
敷地面積	貳萬坪
建築面積	貳千壹百壹坪
建物
建物總延坪	貳千九百參拾貳坪三一一二
事務所	建坪	七拾參坪七七二
本工場	延坪	壹千五百七拾九坪九九八四
ピツチヤード	建坪	五拾貳坪五二○四
綿洗場	〃	拾五坪五〇一六
汽罐場	〃	六拾六坪○七六一
壜置場	〃	壹百五拾八坪六六六六
石炭置場	〃	四拾壹坪五一三九
門衞所	〃	六坪一一七二
コンデンサー上家	〃	四拾坪
製凾室及ツト入室	〃	八十六坪七七四
製品倉庫	建坪	壹百五拾五坪三二九
原料倉庫及物品倉庫	〃	壹百四拾七坪四八二
接待所	〃	五拾坪六
稅務官詰所	〃	六坪二六
職工休憩所	〃	五拾壹坪二
社宅(拾貳棟分)	延坪	四百坪五
高サ
軒高	六拾六尺五寸
最頂部	七拾貳尺八寸
基礎	總掘布掘及壺掘割栗石搗固めの上鐵筋コンクリート及コンクリート造基礎版及繫梁を築造す。
主體構造	鐵骨鐵筋コンクリート造、壁煉瓦版鐵骨鐵筋コンクリート造及木造とす、工場及倉庫には、ビール製造に必要なる特殊構造を施す。
外部仕上	壁は化粧煉瓦仕上、スレート波型及木製下見張とし、屋根は陸屋根に防水層を施し保護モルタル四半目地仕上、スレート波型仕上及瓦葺仕上とす。
內部仕上	床はシートアスフアルト仕上、タイル張及モルタル仕上を主とし、壁はプラスター仕上、漆喰仕上、タイル張仕上、モルタル塗及スレート波型張りとし一部人造石硏出及疊數、コルク敷とす、天井はスレート波型張り、プラスター仕上、漆喰仕上、モルタル仕上及木製とす。
建具	總て木製とす、工場にはビール製造に對し特に防寒防熱裝置を施す。
衞生工事	各便所水洗式及汲取式とし、淨化槽は室外に設け自然流下により放流す。
電燈工事	シーリングライト、パイプベンタント、チエンベンダント及其他適當に配置す。
給水給湯工事	主として鑿井による設備をなし一部水道水使用す、給湯は蒸氣汽罐による。
煖房工事	蒸氣汽罐及ストーブの設備をなす。
エ程	起工	昭和八年五月八日
竣工	昭和九年三月三十一日
工事設計監督	曾禰、中條建築事務所
工事施工	大倉土木株式會社
@