※
工事槪要
朝鮮總督府東京事務所新築工事槪要
樣式	近世式
規模	鐵筋コンクリート造四階建地階付
建坪	二百七坪
地階	二百二十四坪
一階	二百七坪
二階	百九十坪
三階	百七十八坪
四階	百五十四坪
屋階	十坪
延坪	九百六十三坪
建物最高部の高さ地盤面上六十五尺
內外構造の大要	外壁內部主要間仕切、床及柱階段鐵筋コンクリート造、外壁タイル貼りスチールサツシユ嵌込み內部床及腰壁タイル張り人造石硏出し大理石及テラゾー貼等とし壁漆喰塗プラスター塗一部セメントモルタル塗、日本間は木造眞壁塗疊敷とす。
屋根	鐵筋コンクリート造陸屋根防水層張付けコンクリート打の上「クリンカータイル」貼り。
基礎	鐵筋コンクリート杭打(ペデスタル式)地形を施し割栗石敷固め均しコンクリート打の上防水層を施し鐵筋コンクリート基礎を構造す。
設備	煖房	眞空蒸氣煖房
衛生	便所水洗式直接放流裝置
電氣	昇降機一臺、電燈二百二十二箇
電氣時計三十九筒、電話四十四箇
起工	昭和九年七月二日
竣工	昭和十年十月十日
總工費	三十七萬圓
設計者	總督府會計課營繕係
請負人	基礎工事	田中工業株式會社
建物	多田工務店
煖房衞生	同上
電氣	守谷商店(東京)
敷物	高島屋
窓掛	森田傳三郞商店(東京)
昇降機	東洋オーチス・エレベーター株式會社
@
