※
工事槪要
釜山府立病院工事槪要
位置	釜山府谷町二丁目
敷地坪數	七千二百四坪
規模
イ)本館延坪	七百一坪三二七
內譯
地下室	六十九坪○五二
一階	四百十七坪四二五
二階	二百十一坪一八四
塔屋	三坪六六六
ロ)一般病合延坪	千二百二坪二七一
內譯
病棟	七百一坪八三六
附屬建物	五百坪四三五
ハ)傳染病舍延坪	七百七坪二七一
內譯
病棟	四百七十五坪二〇一
附屬建物	二百三十二坪○七
ニ)看護婦寄宿舍延坪	百五十坪六九五
總延坪	二千七百七十一坪五六四
構造(本館)	近世樣式
柱・梁・外壁・其他主要部鐵筋混凝土造、其他一部は煉瓦及木造二階建陸屋根、一部地階及塔屋付、高さ地盤より二階陸屋根パラペツト天端迄四十二尺八寸、塔屋パラペツト天端迄五十四尺一寸、外部壁體人造石洗出し玄關廻り、壁は內外共タイル張り床もザイク張り其他の內部は主要治療室は床及壁腰廻りタイル張り及人造石洗出し、其他は床リノリユーム張り壁及天井共漆喰塗り外部窓スチールサツシユーペンキ塗り、內部木造「ドアーニス」塗り仕上げ
(病棟其他)和洋折衷式
木骨鐵網コンクリート造二階建、軒高地盤より軒桁まで二十六尺、屋根日本瓦葺、外壁スタツコ塗內部便所床モザイツクタイル張り、壁腰廻りタイル張り、腰上天井共漆喰塗り、病室其他各室共床リノリユーム張り、建具木造、木部並に鐵部見え掛けはニス又はペンキ塗り仕上
諸設備
煖房	眞空蒸氣煖房裝置
衞生	水洗式汚水淨化槽裝置及蒸氣消毒
電氣	醫療機、汽罐自動給炭眞空ポンプ應用及電燈
電話	構內共電式
消火	病棟防火壁各屋內外消火栓
給水	淨水道
病棟調理	瓦斯
起工	昭和十年一月二十五日
竣工	昭和十一年三月三十一日
工費	五六三、六〇〇圓
敷地	一八七、九○○圓
建築及設備	三七五、七○○圓
@