※
不知火旅館新築工事槪要
位置	京城府旭町一丁目十番地
敷地面積	五百九十五坪三
建築延面積	五百二十四坪九一七
內譯
地階	23,718坪
一階	123,996坪
二階	124,500坪
三階	120,680坪
四階	74,302坪
屋上階	5,674坪
車寄	5,667坪
附屬家	46,380坪
樣式	日本風を加味した近世式
構造	構造主體鐵筋コンクリート外壁間仕切壁
等に煉瓦造木造を併用す。
高さ	新地盤線より四階パラベツト上端迄	四十九尺五寸
同	三階同	四十三尺
各階配室	地階	使用入室、煖房汽罐室、石炭庫
一階	車寄、玄關、取次間、ホール、應接室、ベランダー、客室日本間、一號、二號、三號、食堂、帳場、內玄關、主人室、同次の間、調理室、女中室、客便所二ケ所、下便所、其他
二階	ホール、客室日本間二〇號、二一號、二二號、二三號、二四號、二五號、二六號、二七號、二八號、二九號、洋間五號、六號、湯沸室、脫衣室、浴室、便所、其他
三階	ホール、客室日本間三○號、三一
號、三二號、三三號、三四號、三五
號、三六號、三七號、三八號、三九
張、七號、八號、湯沸室、脫衣室、
浴室、便所、其他
四階	ホール、客室日本間四〇號、四一
號、四五號、四六號、四七號、四八
號、湯沸室、便所、物置
屋上階	タンク室
附屬家	脫衣空、浴至、老人至、子供室、勉强室、病人室、食堂、便所
外部仕上	腰は正面及右側面一部花崗石亂積とし其他は變色煉瓦積とす。
壁は正面二階床迄タイル張とし其他は色モルタル搔き落し、仕上げ屋根は陸屋根モルタル目地切車寄及塔屋其他小屋根等に日本瓦を使用す、窓は木製建具ペンキ仕上とす。
內部仕上	主要室に於ける仕上次の如し。
車寄	床小砂利洗ひ出し、天井格緣天井ニス仕上
玄關	床モザイクタイル張り、腰タイル
張、壁砂塗り、天井竿緣板張リ
取次間	床疊敷き、壁加工ペンキ及砂塗リ、天井竿緣板張
ホール及廊下	床スーパライト及椽子板色付、壁加工ペンキ及漆喰塗天井漆喰仕上
應接室	床寄木張、壁加工ペンキ、天井テツクス張
ベランダー	床タイル張、腰タイル張、壁天井漆喰仕上
食堂	床椽子板色付、壁紙張、天井テツクス張
客室日本間	床疊敷き、壁砂塗リ仕上、天井竿緣板張
客室洋間	床ブロツク張、壁紙張リ、天井漆喰塗リ
脫衣室	床椽子板色付、壁漆喰、天井網代組張
浴室	床モザイクタイル、壁タイル張、天井化粧裏
便所	床モザイクタイル、腰タイル張、壁漆喰、天井漆喰塗り
煖房設備	溫水煖房とし地下室、汽罐室にアサヒボ
イラー一基を設置し配管に依リ各空の放熱器に導くものとす。
衞生設備	用水は府設上水道及地下至井戶より給水
し各客室其他には洗面器を設け、各便所は淨化裝置となす。
給湯設備	各階浴室及洗面器の給湯は地下室給湯ボイラーを設け、各湯沸室の湯沸は瓦斯七錀台を設く。
消火設備	各階に一箇所消火栓を設備し尙要所は防火シヤツター及防火鐵扉を設置す。
電氣設備	京城電氣會社より電灯用として一〇○ボルトの供給を受け、金屬管隱蔽工事に依り配電盤、分電盤等を經て電灯、電鈴、電氣時計等に配電す。
照明器具	一五〇灯
器具差入口	四八個
電鈴設備	四五個所
私設電話	三七個所
起工	昭和十一年六月一日
竣工	昭和十二年七月十日
工事關係者
設計	合資會社淸水組設計部
建築工事	合資會社淸水組京城支店
煖房衞生工事	旭商會
電氣工事	島田商會
@
