※
崔邸新築工事槪要
位置	京城府竹添町一丁目一番地
敷地面積	一、五八四坪
鐵筋コンクリート造リ	二階建て(地下室付き)	壹棟
延坪數	二六四、四○坪
內譯	壹階	一一七、○○坪
貳階	九〇、八○坪
地下室	五六、六〇坪
構造槪要	鐵筋コンクリート廻リ小屋木造外壁及間仕切壁煉瓦積
外部仕上	腰及窓並入口造り東大門外產の花崗石積壁長手型タイル貼屋根、宮城縣產天然スレート魚鱗葺き、階下スチールサツシ二重建、階上、同一重建て但し硝子二重嵌込むサツシは總てロールスクリーン付きとし仕上はラツカー塗装。
主なる室內仕上
玄關	床ボーダー大理石ホデイ眞中目地入テラブー仕上、中央に大理石製中心飾を嵌込む、腰六尺高舶來大理石張リ壁一部に飾棚を設け上端に陶器モザイツクの飾を嵌込み、下部を傘立及下駄箱に使用し上部に大形鏡を嵌込む、壁天井共潟喰途り蛇腹石膏岩ペンキ仕上。
ホール	床寄木張、腰入口、額緣ニツチ等舶來大理石貼枠及建具はウオールナツト及チーク製ラツカー塗裝、壁、天井漆喰塗ペンキ仕上壁はコルク粒入模樣ペンキ仕上。
應接室	床寄木張中央部假縫下地コルク板張リ腰羽目及壁枠共ウオールナツトベニヤ式アロエ製壁はテツーコー壁紙貼り、天井漆喰ペンキ仕上、ストープ廻リ舶來大理石貼りにして彫刻を施す、建具はウオールナツト製、木部は何れもラツカー仕上。
ベランダー	床モザイツク貼り腰高さ九尺、鮮產大理石貼、屋根硝子屋根の下部にシタ地ベニヤ造り船底化粧天井を設け、彫刻硝子を嵌込み枠及桁繋き共ホワイトブロンズ製化粧金物を取付け建具用硝子は彫刻ガラス及ステンドグラスを嵌込む。
撞球室	床ボーダー寄木張り撞球臺周圍硬質ゴムマツト敷き腰羽目、壁枠、飾棚等、木部は總てオークベニヤ式加工製にしてラツカー塗裝テツコー壁紙貼リとす、ストーブ廻リは鮮產大理石貼付けとし天井は漆喰塗ペンキ仕上。
食堂	床は全體寄木貼り、高羽目及飾棚は總てチークベニヤ式加工製にして隨所に木象嵌を施工す、ベランダー界ケースメントはスチール製にして杢	付ラツカー仕上、天井は漆喰ペンキ仕上げ。
理髪室	床、テラヅー天井、壁は漆喰塗仕上、水性ペンキ塗裝羽は全體シタ地ベニヤ式加工。
書齋	床寄木張り、天井長押化粧梁、高羽目、書棚、ストーブ飾等總てサクラベニヤ式加工にして天井長押及化粧梁は何れも彫刻を施す、木部全體ラツカー仕上、天井及壁一部は漆喰塗ぺンキ仕上、ストーブ火袋及灰は秦山製タイル張リとす。
客間及次の間	使用木材は總て尾州檜柾材とし、敷居は日本松使用、格天井鏡板は桐板を用ひ、床柱鐵ア木自然木床框は呂色仕上、床脇地板、置棚等は欅如輪杢溜色仕上、次の間境ランスは欅製近江八景の丸彫り素地仕上、ラヂエーター引違ひ横には京都二條離宮黑書院寫しの透金物を銀古び仕上となし嵌込む壁は全部砂壁とし床廻リは色違ひのものにて仕上ぐ。
居間及次の間	使用木材は主として尾州檜柾材を使用し、天井板は吉野杉杢板、枠緣廻緣共同材柾日のもの使用し、長押は磨丸太二ツ割を取付け床柱は吉野絞丸太を用ひ、落掛は移杢日を用ふ、床框は面皮付き溜色仕上とし、床脇を書院棚板等は欅如輪杢溜色仕上、押入內部は桐板を張廻す、壁は砂壁仕上とし床廻リは色違ひのものにて仕上ぐ。
次の間天井板は霧島白杢板張り枠緣等居間同材使用、水屋內には爐及流しを設け、瓦斯の設備を施す、壁は砂壁仕上。
廊下	客間、兩脇、床下、天井は枠緣天井とし、何れも杉柾板、張床は尾州檜柾板、緣子板張りとし、階段側廊下床はチークフローリング張りとす。
居間廊下は全部床尾州檜柾板、緣子板張りにして天井は椹の「ノネ」板張掛込天井とし一都杉網代天井押へ緣に赤松丸太を用ふ。長押は杉磨丸太及同材アテ丸太を取付け壁は砂壁仕上とす。階下洋間廊下は床及巾木チーク材使用、壁、天井漆喰塗仕上とし、壁はペンキ叩き仕上とす。
浴室	床及壁はモザイツクタイル貼巾木大理石、天井はモルタル磨き塗にペンキ塗裝、浴槽は尾州檜製箱形にしてシヤワー其他の設備を施す。
階段	正面階段は腰、手拵は舶來大理石貼にして踊場及段左右ホンタンは國產大理石貼としコルク及末松材を以て階段縫下地と施す。側面階段は段及段鼻共タイル貼とし、腰、手拵はララソン仕上とす。壁、天井共漆喰仕上とす。
附帶設備其他工事	全館溫水暖房とし給水衞生其他一切設備完備す。淨化槽はオムス式を用ふ。家具、カーテン、假縫等一切各室に適合する樣設計し備付く。
工期	昭和十一年八月	昭和十三年七月
設計施工	大林組
@