※
工事槪要
朝鮮鐵道株式會社本社々屋新築工事槪要
位置		京城府古市町十四番地
建物階數	地下一階地上四階（一部五階）	計五陸	一部六階）。
建物高		地盤より四階パラペツト迄六十二尺九寸。五階パラペツト迄七十三尺三寸。
延坪		五百六十八坪一合六勺
		地階	百二十六坪一合九勺
		一階	百○二坪六合六勺
		二階	百○二坪六合六勺
		三階	百○坪六合六勺
		四階	百○二坪六合六勺
		五階	三十一坪三合三勺
外觀樣式	近世式
構造		各階共階段、床版、染、柱、基礎は鐵筋混凝土造側張壁及內部各間仕切は煉瓦積とす。
各室配置
（地階）		社員食堂、炊事場、使丁室、倉庫煖房汽罐室、淨化槽、ポンプ室、石炭庫。
（一階）		玄關、ホール、客溜、守衞室、會計係室、倉庫係室、便所。
（二階）		重役室、會議室、應接室、支配人室、廊下、庶務課、便所。
（三階）		營業課、汽車課、庶務課分室、廊下、便所。
（四階）		工務課、豫備室、廊下、便所。
（五階）		電話交換室、圖書室、モーター室タンク室、蓄電池室、暗室、廊下。
外裝		正面側二階窓臺下迄花崗石貼り、上部は化粧「タイル」貼り、背面及左右兩側面根石上ばより二階窓臺下迄人造石塗小叩き仕上げ、上部は前同化粧「タイル」貼り側廻り上下げ窓は各階共建鐵製Ｌ型「サツシユ」を使用す。
内裝
（一階）		玄關は床及腰「タイル」店り壁「ブロケード」塗天井漆喰塗、客溜床及腰「タイル」貼り天井及壁漆喰塗「ホール」床「モザイツク」貼り天井及壁漆喰塗、其他一般事務室床「リノリウム」敷き、壁及天井共漆喰塗、便所各陛共床及腰「タイル」貼り天井及壁漆喰塗とす。
（二階）
重役室		床絨氈敷き腰高羽目貼り、壁紙貼り、天井漆喰塗。
廊下		床人造人磨出塗壁及天井共漆喰塗。
其他		階段は各階共床及腰共（地下室及四階は除く）「タイル」貼り壁漆喰塗。
地下室		社員食堂及炊事場床及腰「タイル」貼り、壁及天井共漆喰塗仕上げとす。
電機設備	電話、五階交換室に私設交換臺一基設備、電氣時計設備とし壁雷針一基設備す。
衞生設備	便所は凡て水洗式とし、地下室に淨化槽を設け、淨化水は「ボンプ」により下水に排水する設備とす。
煖房裝置	低壓蒸氣愛房裝置にして、汽罐室に「レツドフラツシユボイラー」二基据付け、地下室「オイルタンク」庫内の重油を「オイルバーナー」に誘導し燃燒せしむるものとす。
昇降機		日本「ヱレベーター」會社製人員用「ヱレベーター」一基設備す。
工程		工事着手昭和六年四月十八日。竣功昭和七年一月二十三日。
工事設計竝監督	中村誠及朝鐵建築係。
工事施工
建築工事	長門祖	五島榮藏。
煖房及衞生工事	杉山久。
電氣工事	電氣	川北商會
		電話	山田商會
		照明	三光商會
ヱレベーター	日本エレベーター會社
＠