※
工事槪要
平壤博物館新築工事槪要
位置	平壤府牡丹臺(慶上里十五番地)
敷地面積	四千八百九十餘坪
建物坪數	二百三十坪七合四勺
各室配置	車寄、玄關、下足、受付ケ、廣間、事務室、陳列室、特別陳列室、硏究室、化粧、便所
建築樣式	東洋復興式
建物高サ	一般陳列室地上軒迄二十三尺五寸
塔屋相輪寶珠迄四十八尺三寸
平面竝に立面計畫	平面竝に立面構成については將來擴張の場合を考慮し計畫せるものなり。
室內意匠	陳列室內意匠造作は建物樣式に相應すると同時に、陳列品に對する歴史的還元の意味に於ける特別意匠をも加味したり。
構造	(1)構造は煉瓦鐵筋コンクリート本瓦葺平家建てにして、耐火的のものたらしむ。
(2)陳列室の採光方法は總て陳列棚上部より二段の側面光線を探れり。
高窓よりの採光は天井上に傾斜面を設け、反射光線强大ならしむるためプラチナイト仕上げとす。
天井は摺硝子を以て光度の調節と硝子面の反射とを防ぐ。
(3)陳列室は常に溫度・濕度の變節を防止する意味に於て周壁全部二重壁となし、室の上下部適宜に換氣孔を設けたり。
外裝	車寄せ、玄關廻り、竝に腰廻り及び軒庇の大部分(カストストン)仕上げ、其他壁面は人造石(防水劑入)洗ひ出し。
笠石及び地覆廻り順川產の花崗石使用。
室內仕上げ	床カ一部タイル張り車寄せ、玄關テラゾー仕上げ其他防水劑入色モルタル塗り仕上げとし、壁は玄關化粧室、便所腰タイル張り。
廣間腰パーテイツクス、其他スタツマンチユリア塗り仕上げ、天井漆喰塗りとし木部及び戰鐵物見え掛り等はラツカー及びペイント塗り仕上げとす。
給水工事	建物の位置高く水道の直接給水不可能のため動力にて自動給水裝置を施せり。
電燈工事	車寄せ、事務室、化粧室、附屬家周庭四箇所に配置す。
附屬建物	(1)(木槨室)。木造平家建て建坪數四十四坪樂浪古墳一基安置せり。
(2)煉瓦平家建。建坪十七坪一合倉庫。宿直室、小使室、湯沸室等に當つ。
工事期間	起工	昭和七年七月
竣工	昭和八年十月
總工費	七萬圓也
內譯	本館	四萬八千六百圓
木槨室	壹千八百圓
附屬家	壹千五百圓
工事其他諸費	壹萬八千一百圓
工事關係者	設計監督	朝鮮總督府道技手	東三郞
工事請負者	多田組
@