※
永路氏住宅新築工事槪要
位置	京城府錦町二番地(孝昌公園內)
工程	昭和九年三月起工	同年七月竣功
延面積	57.7坪
地階	18.0坪
一階	29.4坪
二 階	10.3坪
構造	地階煉瓦造其の他木造、屋根セメント京都型磨一部石綿スレート文字葺
外廊仕上	セメントモルタル色付搔落仕上タケイ液防水劑入	
各室仕上
地階	內玄關	踏込及巾木大理石亂敷、天井白漆壁黃大津、入口建具ラヲイ塗
子供室	山崎式溫突、天井及壁同上
ベランタン兼勉强室	床板張、天井及壁同上屋根石綿スレートー文字葺
溫室	山崎式溫突子供室、温突と連絡し床セメントタイル張、屋根硝子葺壁白漆喰塗
女中室	山崎式溫突、煙突はポイラー用と兼用、天井白漆喰塗壁黃大津
便所	床及腰タイル張、天井及壁マンチユリア塗、レヂスター取付
物置	床及壁モルタル塗、ボイラ室及喑室兼用
一階	ボーチ	床花崗石敷、腰變色煉瓦積天井白漆喰塗、屋根石綿スレートー文字葺
玄關	床タイル張、腰羽目張天井白漆喰塗、壁カセイン14號塗、入口建具楢柾硝子二分厚面取、フランスドア木部ラツク塗、敷臺板攑
廣間	床楢相互矧張チーク及黑檀ボータン附ラヲイ塗ワツクス仕上天井富士テツクス變張壁同上、木部ラツク塗、入口建具モールー板硝子
應接室兼書齋	床絨繵敷、天井富士テツクスー松張、壁紙張出窓机兼用引出及袖書箱附硝子二分厚面取、ラエターボツクス大理石、加茂更紗、木部ラツク塗
居間	天井米杉柾、壁砂壁磯ノ松、食堂堺建具ダイヤー板硝子白ラツク塗木地出仕上、床柱赤松丸太落掛一位框攑
サンルーム兼食堂	床板張天井白漆喰塗壁紙張建具白ラツク塗、木地出仕上ゲ
老人室	天井米杉松壁砂壁銷土ニ川砂混塗床柱櫻
臺所	床板張天井白漆喰塗壁黃大津、腰廻り一部タイル張、流し瓦斯臺入造石磨出仕上、塵捨口より下部塵箱ニ水洗流裝、瓦斯臺上火氣拔ば風呂煙突に通し他にレヂスター取付
浴室	床、腰、浴槽、タイル張浴槽綠大理石、上り湯及シヤワ裝置、壁天井、モルタル塗のコンクリートペイント塗
洗面及脫衣室	床板張、天井白漆喰塗壁黃大津
便所	床、腰、タイル張、レヂスター取付、壁天井マンチユリア塗小便は水洗裝置
廓下	床板張、天井白漆壁黃大津
二階	座敷	見得掛、總體、檜材、天井米杉木理洗出し、璧砂壁銷床孔雀床柱紫檀落掛神代杉框華櫚木、同床堺ランス神代杉、天然木障子は總て東障子
次之間	同上
バルコニー	セメントタイル張
踏場	床板張、天井白漆喰壁、カセイン壁14號
煖房設備	地階	溫突、一階溫水煖房、二階瓦斯ストーブ
給水給湯設備	臺所、洗面所、浴室、上下便所手洗、子供室手洗、地下室洗濯場、各八口
電燈設備	二〇燈コンセントー、二個
工事請負者	渡利武俊
衛生及煖房工事	蓑田工務所
電燈工事	別府啓吉
家具及裝飾工事	横山商店
@