※
工事槪要
新義州飛行場事務所
朝觧總督府遞信局
日本航空輸送會社	合同建築
滿洲航空輸送會社
新築槪要
位置	新義州府外
建物面積
第一階	遞信局側	二三八・五二平方米
兩會社側	四三五・四○平方米
第二階	遞信局側	九〇・七二平方米
外に
テレス
遞信局側	一五・九六平方米
兩會社側	一〇五・九四平方米
計	一二一・九〇平方米
樣式	近世のもの
用途	遞信局側	航空事務室・郵便事務室稅關室・警官憲兵控室・場長室・應接室・氣象室・宿直室・便所洗面所・小使室・其他
兩會社側	事務室・兩會社主任室・乘務員休憩室・待合室・滿洲稅關室・食堂・宿直室・便所・洗面所小使室・其他
構造	煉瓦造屋根及軒廻り・鐵筋コンクリート造
外部仕上	ネールクリート塗、根石廻りタイル張り。
內部仕上	天井及壁殆んど漆喰塗、場長室・應
接室及兩主任室はリノリーム敷、其他
槪ねモルタル塗。
附帶設備	電燈・電鈴・電氣時計を設置す。
煖房設備	目下施工中
設計	朝鮮總督府遞信局營繕係
施工	宮川工務店
工費	三九○○○圓
@