※
工事槪要
株式會社京城德力新築工事槪要
位置	京城府明治町一丁目五十九番地
敷地面積	全面積	三百五十坪
有効面積	一百二十五坪
建築面積	地階七坪、一階五十坪、二階四十五坪九合五勺、三階四十五坪九合五勺ペントハウス四坪五合、合計一百五十三坪四合
各室配置
(地階)	汽罐室、石炭庫
(一階)	玄關、客溜、營業所、便所、金庫室宿直室
(二階)	廣間、應接室、座敷、居間、臺所、洗面所、浴室、便所
(三階)	便所、女中室、臺所、合宿、食堂、豫備室
建築樣式	近世式
建物高さ	地盤より「パラペツト」上端迄四十六尺二寸、「ペントハウス」上端迄五十二尺八寸
構造	柱、梁、床板、鐵筋コンクリート造外壁煉瓦一枚平積及一枚積、內部間仕切は木造となす
外部仕上	外壁「タイル」張り一部「ネールクリ
ート」仕上、屋上防水層施工「クリンカー」タイル張り
內部仕上	各室床、人造石磨出、「モサイツクタイル」、「フローリングブロツク」張り、ヤマトラバリユーム敷等室に應じて施工なす
玄關、客溜、表階段、二階廣間腰壁は大理石紫更紗張付とし入口廻り金庫廻り花崗石磨張付とし「カウンター」黑御影磨となす
建具造作	外部窓は日本建鐵製スチールサツシユ、三連及四連上下とし、一階營業室廻りスチールンヤツター取付をなす
內部出入口枠は「チーク及ラワン」材使用ワニス仕上とす
煖房裝置	低壓蒸氣煖房裝置とし地下室に汽罐一臺を据付各室「ラヂエーター」に蒸氣を供給し○以下二〇度の場合華氏六十度の溫度を保持せしむ
給湯裝置	溫水用汽罐一臺を地下室に据付三階に容積三十立方尺大の「タンク」に設置し自動式給水となし各臺所、便所浴室に溫水を給湯なす
衞生工事	便所は水洗式とし淨化槽を設け「ポンプアツプ」により排水せしむ
瓦斯工事各「ガラン」を各階臺所、營業室に設備す
電燈工事	各室に電熱を設備し煖房故障等の場合に備へり
其他器具は各室に應じて作製せり
工事期間
起工	昭和八年六月
竣工	昭和八年十二月
總工費	五萬五千五百圓
內譯	建築費	四萬七千圓
煖房衞生費	五千八百圓
柵及敷石	二千七百圓
設計施工	藤澤工務店
煖房衞生工事	蓑田工務所
石材工事	朝鮮美術品製作所
電燈工事	加藤電氣商會
室內裝飾	高島屋京城支店
@