※
京城醫學專門學校附屬醫院外來診療所增築工事槪要
位置	京城府昭格洞一六五番地
建築面積	地階	五拾貳坪貳合五勺
壹階	參百九拾壹坪壹合餘
貳階	貳百五拾貳坪四合六勺餘
參階	貳百五拾壹坪九合八勺餘
屋上階校室及機械室	拾四坪參勺餘
合計	九百六拾貳坪八合貳勺
建築樣式	近世式
建物高さ	地盤より「パツペツト」上端迄四拾貳尺八寸機械室同上端迄五拾六尺
構造	柱、梁、床版鐵筋「コンクリート」造り外側壁壹階煉瓦二枚、貳階、參階同一枚半、積內部間仕切一部同一枚及一枚半、積他は木造となす
外部仕上	外壁燒過煉瓦化粧積、車寄「リソイド」仕上
屋上防水層施工「セメントブロツク」敷調劑室屋根一部「トツプライト」を設く
內部仕上	各室床カ「フロアリユーム」仕上內車寄、玄關、下足預場、注射液室、小兒科學生檢査室、齒科試驗室、齒科手術室、同準備室、眼科試驗室、同手術室、同準備室、皮膚科試驗室
同繃帶交換室、同手術室、同準備室同浴室各階便所總體「タイル」張り眼科暗室「リノリユーム」敷き腰は同上床「タイル」張の室竝齒科診察室、同治療室、受付各階廊下共腰「タイル」張り其他の室は腰「ペンキ」準り壁總體漆喰塗となし各科試驗臺、天秤臺等は人造石硏出し、調劑室內圓柱、下足預臺同上硏出となし小兒科診察室に限り防響裝置として壁、天井「トマテツクス」張り、木部「ホール」玄關廻り「ワニス」塗り他は「ペンキ」塗となす
建具造作	外部窓は日本鋼材會社製「スチールサツシユ」三連及四連、五連辷り出しを使用し、內部は木製とし各科手術室に限り二重窓とす
煖房裝置	別棟汽罐室に高壓汽纒を据付け低壓に變壓して地下暗渠を通じ各室に送氣保溫せしむ
給水給湯裝置	各室に水道管引込治療用溫湯は汽罐室より送りし蒸氣を變湯器にて變湯使用す
衛生工事	便所は手洗式とし淨化槽を設け構外下水溝に流水せしむ
瓦斯工事	各科治療室、試驗室に設備す
電燈電力工事	電燈用として會社より高壓を給け地
下電氣室にて變電の上治療用一般電燈として使用し「エレベーター」月電力は低壓なる爲直接會社より供給を受く
工事期間
起工	昭和七年十一月一日
竣工	昭和八年九月十三日
工費
建築費	九萬九千七拾六圓
煖房衞生費	貳萬七千八百四拾八圓
電燈電力費	七千貳百貳拾四圓
エレベーター設置費	五千八百五拾圓
設計監督	朝鮮總督府官房會計課營繕係
建築工事請負者	大倉土木株式會社
煖房衛生工事請負者	東口商會
電燈工事請負者	加藤商會
雷力裝置工事請負者	川北電氣土木株式會社
エレベーター工事請負者	東洋オーチス株式會社
@
