※
三井物産株式會社京城支店新築工事槪要
起工	昭和十二年九月十日
上棟	昭和十三年七月六日
竣工	昭和十三年十月十八日
樣式	近世式
總延人員	二萬九千五百人
各工事關係者
施主	三井物產株式會社
設計監督	大阪横河工務所
建築工事請負	多田工務店
設備工事請負	三機工業株式會社
エレベーター工事請負	東洋オーチスヱレベーター株式會社
防空暗幕裝置請負	朝日鋼材株式會社
メールシユート工事請負	市川商會
家具類請負	內外木材工藝株式會社
各工事內容
建築工事	構造	鐵筋コンクリート造七階建	建坪	277.9坪
計劃坪數	地階一階付	延	2029坪
今囘竣工坪數	四階迄	延	1210坪
外裝	腰及入口廻り京畿道高陽郡弘濟里產花崗岩本磨き張付けとす
壁面は五糎角磁器防空色釉タイル張りとす
內裝	玄關廻り床テラゾー塗付け仕上げ壁硫球產トラバーチン張り天井プラスター油性ペイント仕上げとす其の他各階とも壁天井プラスター仕上げ床リノタイル張り或はリノリユーム敷き仕上げとす
設備工事	電氣	受變電・電燈・電話・動力・ラヂオ・電鈴・電氣時計・蓄電池・電燈器具等を設備す
煖房	キヤリヤシステムに依る溫濕度調整空氣煖房設備及直接蒸氣煖房設備を併用す
衞生	給水・排水・給湯・消火栓・淨化槽等を設備す
其の他	各部屋換氣設備・塵埃燒却口設備・厨房設備等
ヱレベーター工事	客用	直流ユニツト・マルチ・ボルテーヂ・メーン・モーター・マイクロ式・ギヤード・カー・スヰツチ・コントロール	二臺
ダムウエーター	一臺
@